/*********************************************
 * OPL 12.6.0.0 Data
 * Author: Donzok
 * Creation Date: 29/03/2016 at 17:57:31
 *********************************************/

 MaxCapacity = 200;
 NbElements = 100;
 Elements = [4, 2, 1, 15, 3, 7, 10, 2, 14, 8, 11, 7, 2, 
 			10, 6, 5, 1, 7, 13, 9, 8, 2, 11, 14, 10, 6, 
 			11, 11, 3, 1, 1, 11, 14, 13, 14, 5, 5, 14, 
 			2, 8, 6, 1, 12, 13, 7, 8, 1, 13, 5, 3, 12, 
 			11, 15, 4, 1, 1, 15, 13, 10, 14, 10, 9, 3, 
 			14, 2, 3, 15, 1, 6, 6, 12, 2, 9, 8, 2, 6, 
 			10, 10, 4, 15, 3, 9, 4, 7, 15, 9, 13, 10, 
 			11, 8, 14, 6, 7, 9, 3, 4, 5, 13, 3, 14];