/*********************************************
 * OPL 12.6.0.0 Data
 * Author: Donzok
 * Creation Date: 29/03/2016 at 16:35:21
 *********************************************/

 MaxCapacity = 200;
 NbElements = 100;
 Elements = [11, 8, 22, 24, 15, 38, 12, 19, 32, 25, 
 			 21, 11, 28, 19, 39, 32, 12, 29, 36, 14, 
 			 14, 40, 16, 34, 25, 40, 6, 7, 15, 27, 
 			 25, 28, 6, 18, 37, 26, 26, 30, 33, 40, 
 			 38, 33, 7, 13, 19, 33, 9, 37, 35, 13, 
 			 19, 24, 40, 35, 16, 35, 33, 7, 16, 34, 
 			 8, 25, 22, 5, 10, 13, 37, 30, 31, 17, 
 			 11, 15, 35, 8, 13, 36, 8, 34, 19, 9, 
 			 5, 7, 20, 26, 37, 37, 38, 28, 34, 22, 
 			 16, 21, 11, 22, 14, 15, 21, 32, 26, 29];